6	16
1  2  9  5  3  9  2  3  5  3  2  5  3  3  2  20  
8  9  3  5  11 2  3  3  5  2  3  5  11 2  3  20
15 3  2  19 16 3  17 17 19 11 3  19 16 17 3  20
1  3  16 5  20 3  3  20 1  17 11 20 9  11 7  20 
1  2  11 5  20 3  2  20 1  3  17 20 3  13 5  20
1  11 3  5  20 3  3  20 1  3  3  3  13 3  5  20
0	510	0	384
7
18	14
1	0	0	1	32	64	0	0	0	0	0
2	0	160	1	64	32	0	0	0	1	1
3	0 	192	1	32	192	0	0	0	1	3
4	128	224	1 	64	32	0	0	1	1	2
5	192	160	1	128	32	0	1	2	1	1
6	256	192	1	64	192	0	1	2	1	3
7	384	160	1	192	32	0	2	4	1	1
8	448	192	1	96	192	0	3	4	1	3
9	576	224	1	64	32	0	4	4	1	2
10	640	288	1	128	32	0	4	5	2	2
11	704	160	1	192	32	0	5	6	1	1
12	704	192	1	64	160	0	5	5	1	2
13	960	0	1	64	384	0	7	7	0	3	
14	928	224	1	32	32	0	7	7	1	2
20	7
15	920 	32	1	1	1	25	6	7	0	0	
16	796	32	1	1	1	26	6	6	0	0	
17	664	32	1	1	1	0	5	5	0	0
18	532	32	1	1	1	0	4	4	0	0
19	410	32	1 	1	1	0	3	3	0	0	
20	219	32	1	1	1	0	1	1	0	0
21	90	32	1	1	1	0	0	0	0	0
12	1
22	595	62	1	1	1	0	4	4	0	0
14	2
23	645	220	1	1	1	0	4	5	1	2	
24	239	90	1	1	1	0	1	2	0	1
21	1
25	910	150	1	1	1	0	6	7	1	1
45	2
26	0	125	-1	1472	240	4	0	0	0	0
27	756	377	-1	268	-32	2	5	5	2	2
47	1
28	64	160	1	1	1	0	0	0	1	1