6 24
1  2  2  2  2  2  1  1  1  2  2  2  2  2  1  1  1  1  1  1  4  5  5   6 
7  7  7  7  7  7  3  3  7  7  7  7  7  7  3  3  3  3  3  3  10 11 11 12
7  9  7  7  7  7  7  7  7  9  7  7  7  7  7  7  7  7  9  9  16 17 11 18
9  14 9  9  9  9  9  9  9  14 9  9  9  9  9  9  9  9  14 15 16 23 11 12
27 20 26 27 27 26 27 26 27 20 26 27 27 26 27 26 26 19 20 21 28 29 30 12
25 25 25 25 25 25 25 25 25 25 25 25 25 25 25 25 25 25 25 25 25 25 25 25
0 	1020	0	0
3
19	5
1	176 	256 	1 	1 	1 	26	1	1	2	2
2	448 	256 	1 	1 	1 	24	3	3	2	2
3	704 	256 	1 	1 	1 	24 	5	5	2	2
4	960 	256 	1 	1 	1 	25 	7	7	2	2
5	1200 	256 	1 	1 	1 	4	9	9	2	2
18 	1
6	0 	320 	1 	1556 	32 	0	0	11	2	2
45 	2
7	1376 	240	1 	1260 	290 	49	10	10	1	1
8	1376 	300 	1 	0 	280 	2	10	10	2	2

