6 	8
1   14  15  15  11  7   14  8
1   14  15  11  15  4   14  8 
8   10  17  16  19  15  14  3
8   14  4   15  15  6   10  8
2   14  15  15  11  15  7   8
9   10  16  17  19  19  16  8
0 	0	0	0
8
18 	9
1	0 	352 	1 	512 	32 	0	0	3	2	3
2	0 	0 	1 	32 	256 	0	0	0	0	2
3	32 	128 	1 	32 	128 	0	0	0	1	2
4	64 	160 	1 	256 	32 	0	0	2	1	1
5	352 	224 	1 	160 	32 	0	2	3	1	2
6	352 	224 	1 	160 	32 	0	2	3	1	2	
7	448 	0 	1 	64 	128	0	3	3	0	1	
8	448	192	1	64	192	0	3	3	1	3
9	480	0	1	32	192	0	3	3	0	1
22	2
10	218 	345	1	1	1	0	1	2	2	2	
11	153 	150	1	1	1	0	1	1	1	1
21	1
12	334 	154 	1	1	1	0	2	2	1	1
45	2
13	290	-10	1	735	320	3	2	2	0	0
14	475	169	1	318	323	48	3	3	1	1
14	1
15	160	20	1	1	1	0	1	1	0	0
12	1
16	80	40	1	1	1	0	0	0	0	0
20	3
17	174	224	1	1	1	28	1	1	1	2
18	408	224	1	1	1	0	3	3	1	2
19	290	30	1	1	1	9	2	2	0	0
50	2
20	448	160	1	1	1	51	3	3	1	1
21	448	128	1	1	1	51	3	3	1	1