6	24
1 2 20 18 9 18 17 3 2 2 2 2 5 5 2 5 2 2 5 2 5 2 13 8
1 10 18 20 18 18 17 11 10 13 14 10 9 13 14 3 10 13 14 9 13 14 19 8 
1 18 18 18 20 9 17 10 9 21 22 9 10 4 30 11 18 4 7 10 21 22 10 8
1 9 18 2 2 2 17 19 10 29 30 10 9 12 23 10 18 12 15 9 21 30 18 16
1 2 18 9 18 10 17 10 9 2 10 18 18 6 10 9 18 10 10 10 10 18 18 24
1 18 2 2 26 26 25 26 26 26 26 26 26 26 26 26 26 26 26 26 26 1 1 1 
0 	1020	0	384
8
18	10
1	0	0	1	64	32	0	0	0	0	0
2	0	32	1	64	352	0	0	0	0	3
3	0	256	1	128	32	0	0	0	2	2
4	128	320	1	128	32	0	0	1	2	2
5	192	192	1	192	32	0	1	2	1	1
6	256	352	1	1280	32	0	1	11	2	3
7	1344	320	1	192	64	0	10	11	2	3
8	1472	0	1	64	224	0	11	11	0	1
9	576	256	1	64	20	0	4	4	2	2
10	832	256	1	64	20	0	6	6	2	2

15	1
11	95	180	1	1	1	0	0	0	1	1

17	3
12	840	226	1	1	1	25	6	6	1	1
13	594	226	1	1	1	25	4	4	1	1
14	350	160	1	1	1	25	2	2	1	1

13	1	
15	1410 	220	1	1	1	0	10	10	1	1

20	3
16	1460	270	1	1	1	0	11	11	2	2
17	1330	300	1	1	1	0	10	10	2	2
18	320	135	1	1	1	0	2	2	1	1

22	1
19	320	190	-1	1	1	0	2	2	1	1

45	1
20	175 	-10	-1	168	320	5	1	1	0	0

50	1
21	832	256	2	1	1	32	6	6	2	2