6 24
1 1 23 2 1 23 16 1 23 15 17 5 1 6 23 5 1 6 23 5 1 26 16 7
1 2 3 1 1 3 25 1 3 4 2 1 23 6 3 5 23 6 3 5 23 15 25 7
8 9 9 10 11 3 25 1 3 22 1 1 3 1 3 1 3 1 3 16 3 22 25 14
15 1 23 17 18 9 8 9 9 10 11 1 3 1 3 1 3 1 3 2 3 20 13 21
22 1 3 1 16 3 2 3 2 17 12 11 3 1 3 1 3 1 3 1 3 27 19 7
8 8 24 8 8 24 8 24 8 8 8 18 24 8 24 8 24 8 24 8 24 8 8 28
0 	1020	0	384
6

18 	5
1	0 	160 	1	224 	32	0 0 1 1 1
2	256 	224 	1	352 	32 	0 1 4 1 2
3	0 	352	1	1536 	32	0 0 11 2 3
4	1344	288	1	32	32	0 10 10 2 2
5	1440	224	1	96	32	0 10 11 1 2	

50	1
6	1376	288	3	1	1	30 10 10 2 2

16	1
7	1170	28	1	1	1	29 8 9 0 0

10	3
8	10	250	1	1	1	0 0 0 1 2
9	50	250	1	1	1	0 0 0 1 2
10	90	250	1	1	1	0 0 0 1 2

21	2
11	190	88	-1	1	1	0 1 1 0 0
12	574	152	-1	1	1	0 4 4 1 1

22	2
13	736	350	-1	1	1	0 5 5 2 2
14	285	223	-1	1	1	0 2 2 1 1