6	24
1 3 4 4 3 18 18 18 18 18 18 18 18 18 18 18 18 18 18 18 18 18 18 1
1 4 4 5 4 18 18 18 10 10 18 18 18 18 13 18 18 18 18 18 16 10 10 1
1 4 4 3 4 18 18 13 11 12 13 18 18 18 2  10 10 10 10 14 22 5  4  9
1 4 5 2 1 18 12 20 17 18 4  13 13 10 21 19 4  7  6  3  6  4  19 15
1 4 2 4 4 14 14 5  3  3  4  4  2  7  3  13 4  11 12 6  4  19 13 1
1 1 8 5 5 20 7  7  7  20 13 7  4  17 7  19 19 17 13 7  7  4  4  1
0	1020	0	0
7

18	17
1	0	0	1	64	384	0 0 0 0 3
2	64	320	1	64	64	0 0 0 2 3
3	160	320	1	32	32	0 1 1 2 2
4	256	192	1	64	64	0 1 2 1 2
5	320	320	1	320	32	0 2 4 2 2
6	448	192	1	64	32	0 3 3 1 1
7	704	320	1	64	32	0 5 5 2 2
8	832	256	1	64	32	0 6 6 2 2
9	896	320	1	64	32	0 6 7 2 2
10	960	352	1	128	32	0 7 8 2 3
11	960	224	1	64	32	0 7 7 1 2
12	1088	192	1	64	32	0 8 8 1 1
13	1216	320	1	128	32	0 9 10 2 2
14	1344	288	1	64	32	0 10 10 2 2
15	1408	224	1	64	32	0 10 11 1 2
16	1472	0	1	64	160	0 11 11 0 1
17	1472	256	1	64	128	0 11 11 2 3

21	4
18	90	247	-1	1	1	0 0 1 1 2
19	240	119	1	1	1	0 1 2 0 1
20	814	181	1	1	1	0 6 6 1 1
21	1118	119	-1	1	1	0 8 8 0 1

22	3
22	124	315	1	1	1	0 0 1 2 2
23	765	315	1	1	1	0 5 6 2 2
24	1282	315	-1	1	1	0 9 10 2 2

15	2
25	720	254	-1	1	1	0 5 5 1 2
26	1340	222	-1	1	1	0 10 10 1 2

11	4
27	545	58	-1	1	1	0 4 4 0 0
28	832	155	-1	1	1	0 6 6 1 1
29	960	100	-1	1	1	0 7 7 0 1
30	1052	320	-1	1	1	0 7 8 2 2

13	1
31	64	0	1	1	1	0 0 0 0 0

45	2
32	192	375	1	159	0	4 1 1 2 2
33	1531	232	1	0	80	6 11 11 1 1